暴行	近卫	三测暂不实装，女性干员	否
德克萨斯	先锋	控场，近战位，费用回复，资深干员，女性干员	是
凛冬	先锋	支援，近战位，费用回复，资深干员，女性干员	是
白面鸮	医疗	远程位，治疗，支援，资深干员，女性干员	是
赫默	医疗	远程位，治疗，资深干员，女性干员	是
华法琳	医疗	远程位，治疗，支援，资深干员，女性干员	是
阿米娅	术师	远程位，输出，女性干员	否
夜魔	术师	三测暂不实装，女性干员	否
天火	术师	控场，远程位，群攻，资深干员，女性干员	否
红	特种	近战位，控场，快速复活，资深干员，女性干员	是
狮蝎	特种	生存，近战位，输出，资深干员，女性干员	是
崖心	特种	输出，近战位，位移，资深干员，女性干员	是
食铁兽	特种	减速，近战位，位移，资深干员，女性干员	是
普罗旺斯	狙击	远程位，输出，资深干员，女性干员	是
蓝毒	狙击	远程位，输出，资深干员，女性干员	是
守林人	狙击	远程位，输出，爆发，资深干员，女性干员	是
陨星	狙击	远程位，群攻，削弱，资深干员，女性干员	是
白金	狙击	远程位，输出，资深干员，女性干员	是
初雪	辅助	远程位，削弱，资深干员，女性干员	是
真理	辅助	远程位，减速，输出，资深干员，女性干员	是
梅尔	辅助	远程位，召唤，控场，资深干员，女性干员	是
空	辅助	支援，远程位，治疗，资深干员，女性干员	否
芙兰卡	近卫	近战位，输出，生存，资深干员，女性干员	否
幽灵鲨	近卫	近战位，群攻，生存，资深干员，女性干员	是
因陀罗	近卫	近战位，输出，生存，资深干员，女性干员	是
陈	近卫	近战位，群攻，支援，女性干员	否
拉普兰德	近卫	近战位，输出，削弱，资深干员，女性干员	否
临光	重装	近战位，防护，治疗，资深干员，女性干员	是
雷蛇	重装	近战位，防护，输出，资深干员，女性干员	是
火神	重装	近战位，输出，防护，生存，资深干员，女性干员	是
可颂	重装	近战位，位移，防护，资深干员，女性干员	是